RRRRRRRRRRLLLLLLLLLLLLLLLLLLLLLLLLLLLLLLLLLLLLLLLLLLLLLLLLLLLLLLLL.......LLLLLLLLLLLLLLLLLLLRRRRRRRRRRRRRRRRLLLLLLLLLLLLLLLLLLLLLLLLLLL..........RRRRRRRRRRRRRR
RRRRRRRRRRLLLLLLLLLLLLLLLLLLLLLLLLLLLLLLLLLLLLLLLLLLLLLLLLLLLLLLL........LLLLLLLLLLLLLLLLLLLRRRRRRRRRRRRRRRRLLLLLLLLLLLLLLLLLLLLLLL..............RRRRRRRRRRRRRR
RRRRRRRRRRLLLLLLLL.LLLLLLLL.LLLLLLLLLLLLLLLT.LLLLLLLLLLLLLLLLLL..........LLLLLLLLLLLLLLLLL...................LLLLLLLLLLLLLLLLLLLL................RRRRRRRRRRRRRR
RRRRRRRRRR.LLLLLL...LLLLLT...LLLLLLL.LLL...T.TLLLL..LLLLLLL......RRRRR....LLLLLLL...LLLLL......................LLLLL..LLLLLLLLL..................RRRRRRRRRRRRRR
RRRRRRRRRR..LLLT.....LLL.T....TLLL....L....T.T.LL.....LLL......RRR...RRR....LLLL.....L.T.........................L.......LLLL....................RRRRRRRRRRRRRR
RRRRRRRRRR...T.T......T..T....T.T.....T....T.T..T......L.......RR.....RR......T..RR..T.T.........................T.......T.L.....................RRRRRRRRRRRRRR
RRRRRRRRRR...T.T......T..T....T.T.....T....T.T..T....R.T..R...................T..RRRRT.T.........................T.......T.T.....................RRRRRRRRRRRRRR
RRRRRRRRRR...TPT......T..T..A.T.T.....T....T.T..T.RRRR.T..RR..................T.RRR..T.T.........................T.......T.T...........RR........RRRRRRRRRRRRRR
RRRRRRRRRRS..GGGGGGS..GGGGGGGGGGGGGGGGGGGGGGGGGGGGRGGGGGGRRRGGGGGGGGGGGGGGGS..GGGGGRRRGGGGGS...............GGGGGGGGGGGGGGGGGGGS..GGGGGRRRGGGGGGGGRRRRRRRRRRRRRR
MMMMMMMMMMMMMMMMMMMMMMMMMMMMMMMMMMMMMMMMMMMMMMMMMMMMMMMMMMMMMMMMMMMMMMMMMMMMMMMMMMMMMMMMMMMMMM.............MMMMMMMMMMMMMMMMMMMMMMMMMMMMMMMMMMMMMMMMMMMMMMMMMMMM
EEEEEEEEEEEEEEEEEEEEEEEEEEEEEEEEEEEEEEEEEEEEEEEEEEEEEEEEEEEEEEEEEEEEEEEEEEEEEEEEEEEEEEEEEEEEEEHHHHHHHHHHHHHEEEEEEEEEEEEEEEEEEEEEEEEEEEEEEEEEEEEEEEEEEEEEEEEEEEE
EEEEEEEEEEEEEEEEEEEEEEEEEEEEEEEEEEEEEEEEEEEEEEEEEEEEEEEEEEEEEEEEEEEEEEEEEEEEEEEEEEEEEEEEEEEEEEEEEEEEEEEEEEEEEEEEEEEEEEEEEEEEEEEEEEEEEEEEEEEEEEEEEEEEEEEEEEEEEEE