RRRRRRRRRRLLLLLLLLLLLLLLLLLLLLLLLLLLLLLLLLLLLLLLLLLLLLLLLLLLLLLLLL.......LLLLLLLLLLLLLLLLLLLRR
RRRRRRRRRRLLLLLLLLLLLLLLLLLLLLLLLLLLLLLLLLLLLLLLLLLLLLLLLLLLLLLLL........LLLLLLLLLLLLLLLLLLLRR
RRRRRRRRRRLLLLLLLL.LLLLLLLL.LLLLLLLLLLLLLLLT.LLLLLLLLLLLLLLLLLL..........LLLLLLLLLLLLLLLLL....
RRRRRRRRRR.LLLLLL...LLLLLT...LLLLLLL.LLL...T.TLLLL..LLLLLLL......RRRRR....LLLLLLL...LLLLL.....
RRRRRRRRRR..LLLT.....LLL.T....TLLL....L....T.T.LL.....LLL......RRR...RRR....LLLL.....L.T......
RRRRRRRRRR...T.T......T..T....T.T.....T....T.T..T......L.......RR.....RR......T..RR..T.T......
RRRRRRRRRR...T.T......T..T....T.T.....T....T.T..T....R.T..R...................T..RRRRT.T......
RRRRRRRRRR...TPT......T..T..A.T.T.....T....T.T..T.RRRR.T..RR............S..T..RR..T.T.........
RRRRRRRRRRS..GGGGGGS..GGGGGGGGGGGGGGGGGGGGGGGGGGGGRGGGGGGRRRGGGGGGGGGGGGGGGGGGGGRRRGGGGGGGGS..
MMMMMMMMMMMMMMMMMMMMMMMMMMMMMMMMMMMMMMMMMMMMMMMMMMMMMMMMMMMMMMMMMMMMMMMMMMMMMMMMMMMMMMMMMMMMMM
EEEEEEEEEEEEEEEEEEEEEEEEEEEEEEEEEEEEEEEEEEEEEEEEEEEEEEEEEEEEEEEEEEEEEEEEEEEEEEEEEEEEEEEEEEEEEE
EEEEEEEEEEEEEEEEEEEEEEEEEEEEEEEEEEEEEEEEEEEEEEEEEEEEEEEEEEEEEEEEEEEEEEEEEEEEEEEEEEEEEEEEEEEEEE