RRRRLLLLLLLLLLLLLLLLLLLLLLLL
RRRRLLLLLLLLLLLLLLLLLLLLLLLL
RRRRLLLLLLLL.LLLLLLLL.LLLLLL
RRRR.LLLLLL...LLLLLT...LLLLL
RRRR..LLLT.....LLL.T....TLLL
RRRR...T.T......T..T....T.T.
RRRR...T.T......T..T....T.T.
RRRR...TPT......T..T....T.T.
RRRRS..GGGGGGS..GGGGGGGGGGGG
RRRRMMMMMMMMMMMMMMMMMMMMMMMM
RRRREEEEEEEEEEEEEEEEEEEEEEEE
RRRREEEEEEEEEEEEEEEEEEEEEEEE