RRRRRRRRRRLLLLLLLLLLLLLLLLLLLLLLLLLLLLLLLLLLLLLLLLLLLLLLLLLLLLLLLL.......LLLLLLLLLLLLLLLLLLLRRRRRRRRRRRRRRRRLLLLLLLLLLLLLLLLLLLLLLLLLLL..........RRRRRRRRRRRRRR
RRRRRRRRRRLLLLLLLLLLLLLLLLLLLLLLLLLLLLLLLLLLLLLLLLLLLLLLLLLLLLLLL........LLLLLLLLLLLLLLLLLLLRRRRRRRRRRRRRRRRLLLLLLLLLLLLLLLLLLLLLLL..............RRRRRRRRRRRRRR
RRRRRRRRRRLLLLLLLL.LLLLLLLL.LLLLLLLLLLLLLLLT.LLLLLLLLLLLLLLLLLL..........LLLLLLLLLLLLLLLLL...................LLLLLLLLLLLLLLLLLLLL................RRRRRRRRRRRRRR
RRRRRRRRRR.LLLLLL...LLLLLT...LLLLLLL.LLL...T.TLLLL..LLLLLLL..............LLLLLLL...LLLLL......................LLLLL..LLLLLLLLL...................RRRRRRRRRRRRRR
RRRRRRRRRR..LLL......LLL.T....TLLL....L....T.T.LL.....LLL...................LLLL.....L.T.................d.......L.......LLLL....................RRRRRRRRRRRRRR
RRRRRRRRRR.D.T....d...T..T....T.T.....T.d..T.T..T......L..d........D..d.d.....T......T.T.........................T.......T.L........d............RRRRRRRRRRRRRR
RRRRRRRRRR...T.....d..Td.T..d.T.T...D.T..d.T.T..T.d....T......d.d......d......T...D..T.T........d.............d..T....d..T.T...d.d......D.....d.dRRRRRRRRRRRRRR
RRRRRRRRRR...TP.......T..T..A.T.T.d.F.T..D.T.T..T.d.D..T.....F...d......d.....T.d....T.T......D.......F.d.F..d...T.F.....T.T.D.....A......d......RRRRRRRRRRRRRR
RRRRRRRRRRS..GGGGdGS..GGGGGGGGGGGGGGGGGGGGGGGGGGGGS..GGGGGGdGGGGGdGGDGGGGGGS..GGGGGGGGGGGGdS..GGGGS..GGGGGGGGGGGGGGGGGGGGGGGGGS..GGGGd.d.GGGCGS..RRRRRRRRRRRRRR
MMMMMMMMMMMMMMMMMMMMMMMMMMMMMMMMMMMMMMMMMMMMMMMMMMMMMMMMMMMMMMMMMMMMMMMMMMMMMMMMMMMMMMMMMMMMMMMMMMMMMMMMMMMMMMMMMMMMMMMMMMMMMMMMMMMMMMMMMMMMMMMMMMMMMMMMMMMMMMM
EEEEEEEEEEEEEEEEEEEEEEEEEEEEEEEEEEEEEEEEEEEEEEEEEEEEEEEEEEEEEEEEEEEEEEEEEEEEEEEEEEEEEEEEEEEEEEEEEEEEEEEEEEEEEEEEEEEEEEEEEEEEEEEEEEEEEEEEEEEEEEEEEEEEEEEEEEEEEEE
EEEEEEEEEEEEEEEEEEEEEEEEEEEEEEEEEEEEEEEEEEEEEEEEEEEEEEEEEEEEEEEEEEEEEEEEEEEEEEEEEEEEEEEEEEEEEEEEEEEEEEEEEEEEEEEEEEEEEEEEEEEEEEEEEEEEEEEEEEEEEEEEEEEEEEEEEEEEEEE