RRRRRRRRRRLLLLLLLLLLLLLLLLLLLLLLLLLLLLLLLLLLLLLLLLLLLLLLLLLLLLLLLL.......LLLLLLLLLLLLLLLLLLLRRRRRRRRRRRRRRRRLLLLLLLLLLLLLLLLLLLLLLLLLLL..........RRRRRRRRRRRRRR
RRRRRRRRRRLLLLLLLLLLLLLLLLLLLLLLLLLLLLLLLLLLLLLLLLLLLLLLLLLLLLLLL........LLLLLLLLLLLLLLLLLLLRRRRRRRRRRRRRRRRLLLLLLLLLLLLLLLLLLLLLLL..............RRRRRRRRRRRRRR
RRRRRRRRRRLLLLLLLL.LLLLLLLL.LLLLLLLLLLLLLLLT.LLLLLLLLLLLLLLLLLL..........LLLLLLLLLLLLLLLLL...................LLLLLLLLLLLLLLLLLLLL................RRRRRRRRRRRRRR
RRRRRRRRRR.LLLLLL...LLLLLT...LLLLLLL.LLL...T.TLLLL..LLLLLLL..............LLLLLLL...LLLLL......................LLLLL..LLLLLLLLL...................RRRRRRRRRRRRRR
RRRRRRRRRR..LLLT.....LLL.T....TLLL....L....T.T.LL.....LLL...................LLLL.....L.T.........................L.......LLLL....................RRRRRRRRRRRRRR
RRRRRRRRRR...T.T......T..T....T.T.....T....T.T..T......L......................T......T.T.........................T.......T.L.....................RRRRRRRRRRRRRR
RRRRRRRRRR...T.T......T..T....T.T.....T....T.T..T......T......................T......T.T.........................T.......T.T.....................RRRRRRRRRRRRRR
RRRRRRRRRR...TPTF.....T..T..A.T.T....FT....T.T..T......T......................T......T.T.........................T.......T.T.....................RRRRRRRRRRRRRR
RRRRRRRRRRS..GGGGGGS..GGGGGGGGGGGGGGGGGGGGGGGGGGGGGGGGGGGGGGGGGGGGGGGGGGGGGS..GGGGGGGGGGGGGS...............GGGGGGGGGGGGGGGGGGGS..GGGGGGGGGGGGGGGGRRRRRRRRRRRRRR
MMMMMMMMMMMMMMMMMMMMMMMMMMMMMMMMMMMMMMMMMMMMMMMMMMMMMMMMMMMMMMMMMMMMMMMMMMMMMMMMMMMMMMMMMMMMMM.............MMMMMMMMMMMMMMMMMMMMMMMMMMMMMMMMMMMMMMMMMMMMMMMMMMMM
EEEEEEEEEEEEEEEEEEEEEEEEEEEEEEEEEEEEEEEEEEEEEEEEEEEEEEEEEEEEEEEEEEEEEEEEEEEEEEEEEEEEEEEEEEEEEEHHHHHHHHHHHHHEEEEEEEEEEEEEEEEEEEEEEEEEEEEEEEEEEEEEEEEEEEEEEEEEEEE
EEEEEEEEEEEEEEEEEEEEEEEEEEEEEEEEEEEEEEEEEEEEEEEEEEEEEEEEEEEEEEEEEEEEEEEEEEEEEEEEEEEEEEEEEEEEEEEEEEEEEEEEEEEEEEEEEEEEEEEEEEEEEEEEEEEEEEEEEEEEEEEEEEEEEEEEEEEEEEE