RRRRLLLLLLLLLLLLLLLLLLLLLLLL
RRRRLLLLLLLLLLLLLLLLLLLLLLLL
RRRRLLLLLLLL.LLLLLLLL.LLLLLL
RRRR.LLLLLL...LLLLLT...LLLLL
RRRR..LLLT.....LLL.T....TLLL
RRRR...T.T......T..T....T.T.
RRRR...T.T......T..T....T.T.
RRRR...TPT......T..T..AT.T.
RRRRS..GGGGGGS..GGGGGGGGGGGG
RRRRMMMMMMMMMMMMMMMMMMMMMMMM
EEEEEEEEEEEEEEEEEEEEEEEEEEEE
EEEEEEEEEEEEEEEEEEEEEEEEEEEE