LLLLLLLLLLLLLLLLLLLLLLLL
LLLLLLLLLLLLLLLLLLLLLLLL
LLLLLLLL.LLLLLLLL.LLLLLL
.LLLLLL...LLLLLT...LLLLL
..LLLT.....LLL.T....TLLL
...T.T......T..T....T.T.
...T.T......T..T....T.T.
...TPT......T..T....T.T.
S..GGGGGGS..GGGGGGGGGGGG
MMMMMMMMMMMMMMMMMMMMMMMM
EEEEEEEEEEEEEEEEEEEEEEEE
EEEEEEEEEEEEEEEEEEEEEEEE