RRRRRRRRRRLLLLLLLLLLLLLLLLLLLLLLLLLLLLLLLLLLLLLLLLLLLLLLLLLLLLLLLL.......LLLLLLLLLLLLLLLLLLLRRRRRRRRRRRRRRRRLLLLLLLLLLLLLLLLLLLLLLLLLLL..........RRRRRRRRRRRRRR
RRRRRRRRRRLLLLLLLLLLLLLLLLLLLLLLLLLLLLLLLLLLLLLLLLLLLLLLLLLLLLLLL........LLLLLLLLLLLLLLLLLLLRRRRRRRRRRRRRRRRLLLLLLLLLLLLLLLLLLLLLLL..............RRRRRRRRRRRRRR
RRRRRRRRRRLLLLLLLL.LLLLLLLL.LLLLLLLLLLLLLLLT.LLLLLLLLLLLLLLLLLL..........LLLLLLLLLLLLLLLLL...................LLLLLLLLLLLLLLLLLLLL................RRRRRRRRRRRRRR
RRRRRRRRRR.LLLLLL...LLLLLT...LLLLLLL.LLL...T.TLLLL..LLLLLLL..............LLLLLLL...LLLLL......................LLLLL..LLLLLLLLL...................RRRRRRRRRRRRRR
RRRRRRRRRR..LLLT.....LLL.T....TLLL....L....T.T.LL.....LLL...................LLLL.....L.T.........................L.......LLLL....................RRRRRRRRRRRRRR
RRRRRRRRRR.D.T.T..d...T..T....T.T.....T.d..T.T..T......L..d........D..d.d.....T......T.T.........................T.......T.L.....................RRRRRRRRRRRRRR
RRRRRRRRRR...T.T...d..Td.T..d.T.T...D.T..d.T.T..T.d....T......d.d......d......T...D..T.T........d.............d..T....d..T.T...d.d......D.....d.dRRRRRRRRRRRRRR
RRRRRRRRRR...TPT......T..T..A.T.T.d..FT..D.T.T..T.d.D..T.....F...d......d....T..d...T.T.......DD......F.d.F..d..T..F....T.T.D.....A......d......RRRRRRRRRRRRRR
RRRRRRRRRRS..GGGGdGS..GGGGGGGGGGGGGGGGGGGGGGGGGGGGS..GGGGGGdGGGGGdGGDGGGGGGS..GGGGGGGGGGGGdS..GGGGS..GGGGGGGGGGGGGGGGGGGGGGGGGS..GGGGd.d.GGGCGS..RRRRRRRRRRRRRR
MMMMMMMMMMMMMMMMMMMMMMMMMMMMMMMMMMMMMMMMMMMMMMMMMMMMMMMMMMMMMMMMMMMMMMMMMMMMMMMMMMMMMMMMMMMMMMMMMMMMMMMMMMMMMMMMMMMMMMMMMMMMMMMMMMMMMMMMMMMMMMMMMMMMMMMMMMMMMMM
EEEEEEEEEEEEEEEEEEEEEEEEEEEEEEEEEEEEEEEEEEEEEEEEEEEEEEEEEEEEEEEEEEEEEEEEEEEEEEEEEEEEEEEEEEEEEEEEEEEEEEEEEEEEEEEEEEEEEEEEEEEEEEEEEEEEEEEEEEEEEEEEEEEEEEEEEEEEEEE
EEEEEEEEEEEEEEEEEEEEEEEEEEEEEEEEEEEEEEEEEEEEEEEEEEEEEEEEEEEEEEEEEEEEEEEEEEEEEEEEEEEEEEEEEEEEEEEEEEEEEEEEEEEEEEEEEEEEEEEEEEEEEEEEEEEEEEEEEEEEEEEEEEEEEEEEEEEEEEE