RRRRRRRRRRLLLLLLLLLLLLLLLLLLLLLLLLLLLLLLLLLLLLLLLLLLLLLLLLLLLLLLLL.......LLLLLLLLLLLLLLLLLLLRRRRRRRRRRRRRRRRLLLLLLLLLLLLLLLLLLLLLLLLLLL........................
RRRRRRRRRRLLLLLLLLLLLLLLLLLLLLLLLLLLLLLLLLLLLLLLLLLLLLLLLLLLLLLLL........LLLLLLLLLLLLLLLLLLLRRRRRRRRRRRRRRRRLLLLLLLLLLLLLLLLLLLLLLL............................
RRRRRRRRRR..LLLT.....LLL.T....TLLL....L....T.T.LL.....LLL......RRR...RRR....LLLL.....L.T.........................L.......LLLL..................................
RRRRRRRRRRLLLLLLLL.LLLLLLLL.LLLLLLLLLLLLLLLT.LLLLLLLLLLLLLLLLLL..........LLLLLLLLLLLLLLLLL...................LLLLLLLLLLLLLLLLLLLL..............................
RRRRRRRRRR.LLLLLL...LLLLLT...LLLLLLL.LLL...T.TLLLL..LLLLLLL......RRRRR....LLLLLLL...LLLLL......................LLLLL..LLLLLLLLL................................
RRRRRRRRRR...T.T......T..T....T.T.....T....T.T..T......L.......RR.....RR......T..RR..T.T.........................T.......T.L...................................
RRRRRRRRRR...T.T......T..T....T.T.....T....T.T..T....R.T..R...................T..RRRRT.T.........................T.......T.T...................................
RRRRRRRRRRS..GGGGGGS..GGGGGGGGGGGGGGGGGGGGGGGGGGGGRGGGGGGRRRGGGGGGGGGGGGGGGGGGGGRRRGGGGGGGGS...............GGGGGGGGGGGGGGGGGGGS..GGGGGRRRGGGGGGGGRRRRRRRRRRRRRR
RRRRRRRRRR...TPT......T..T..A.T.T.....T....T.T..T.RRRR.T..RR............S..T..RR..T.T............................T.......T.T...........RR......................
MMMMMMMMMMMMMMMMMMMMMMMMMMMMMMMMMMMMMMMMMMMMMMMMMMMMMMMMMMMMMMMMMMMMMMMMMMMMMMMMMMMMMMMMMMMMMM.............MMMMMMMMMMMMMMMMMMMMMMMMMMMMMMMMMM..........MMMMMMMM
EEEEEEEEEEEEEEEEEEEEEEEEEEEEEEEEEEEEEEEEEEEEEEEEEEEEEEEEEEEEEEEEEEEEEEEEEEEEEEEEEEEEEEEEEEEEEEHHHHHHHHHHHHHEEEEEEEEEEEEEEEEEEEEEEEEEEEEEEEEEEHHHHHHHHHHEEEEEEEE
EEEEEEEEEEEEEEEEEEEEEEEEEEEEEEEEEEEEEEEEEEEEEEEEEEEEEEEEEEEEEEEEEEEEEEEEEEEEEEEEEEEEEEEEEEEEEEEEEEEEEEEEEEEEEEEEEEEEEEEEEEEEEEEEEEEEEEEEEEEEEEEEEEEEEEEEEEEEEEE