LLLLLLLLLLL
LLLLLLLLLLL
LLLLLLLL.LL
.LLLLLL...L
..LLLT.....
...T.T.....
...T.T.....
...TPT.....
S..GGGGGGS.
MMMMMMMMMMM
EEEEEEEEEEE
EEEEEEEEEEE