RRJJRJRJRRRJRJRRRRRRRRRJRJRRRJJJJ.JJJRRRRRRRRRJJJRRRRRRRRRRRRJRRRRRRRRRRRJJRJRJJRJRJRJRJJJRRRRJRRJJRJJJJJJJRJRJJJRJRJRJJRJJRRRRRRRRJJRJRRRRRJRJRRJJJRJRJRRRRRRR
RJRJRRJRJRJJRRRJ..JJRR.RR.R.RRR...R..RRRRRJ.JRRRRRRRJ.J....JJJJ.JJJ...R.JR.JRJ.JRRJ.JRJJ....JRJJRJRJRR...RJJRJJR.RJJRJR.JRJR.JRJ..JRJRJRJ.RJR.RJJRRRJRRJJJRRRRR
RJRRRJJJRJRJJJR...BB..BB....BBB....BBB....B.........BB.BBBB....BB.BBBB.BBB.BB.B...BB....BBBB....BBBB.BBBB..B.B..BBBB.B.BBB..B.B..B.B.B..BB....RJRJRRRRJRJJRJRRR
RJRJJRJRJRJJRRRBBBBBBBBB...BBBBBBBBB..B...BBBBBBBBBBBBBBBBBB..BBBBBBBB.BBBBBBBBB..BBBBBBBBB.B.BBBB..B.B.BBBBBBBB.B.BBBBBBBBBBBBBB..BBBBBBB....RJRJRJRJJRRRRRRRR
RJJRJJJJJJRRJJJBBBBBBBBBBBBBBBBBBBBBBBBBBBBBBBBBBBBBBBBBBBBBBBBBBBBBBBBBBBBBBBBBBBBBBBBBBBBBBBBBBBBBBBBBBBBBBBBBBBBBBBBBBBBBBBBBBBBBBBBBBBBBBBRJRJJJRRRRJRJRRRR
RJJRJJRJRJRRJJRBBBBBBBBBBBBBBBBBBBBBBBBBBBBBBBBBBBBBBBBBBBBBBBBBBBBBBBBBBBBBBBBBBBBBBBBBBBBBBBBBBBBBBBBBBBBBBBBBBBBBBBBBBBBBBBBBBBBBBBBBBBBBBBRJRRRRRRJRJJRJJRR
JJJJJRRRRJJJRJJBBBBBBBBBBBBBBBBBBBBBBBBBBBBBBBBBBBBBBBBBBBBBBBBBBBBBBBBBBBBBBBBBBBBBBBBBBBBBBBBBBBBBBBBBBBBBBBBBBBBBBBBBBBBBBBBBBBBBBBBBBBBBBBRRJRJRJJRRJRJRRRR
RRJRRJJJJRRRRJJ..BBBBBPBBdBBdBBABdBBFdBBBdBBBBBBBBBBBBBBBBBBBBABBBBBBBBBBBBBBBBBBBBBBBBBBBBBBBBBBBBABBBBBBBBBBBBBBBBBBBBBBBBBBBBBBBBBBBBBBBB..RJJRRRRRRJRJRRRRR
RJJRJRJRJRJJRJRI.BBBBBBBBBBBBBBBBBBBBBBBBdBBdBBBBBBBBBBBBBBBBBBBBBBBBBBBBBBBBBBBBBBBBBBBBBBBBBBBBBBBBBBBBBBBBBBBBBBBBBBBBBBBBBBBBBBBBBBBCBBI.JJJJRRRRRRRJJRJRJ
JRJJRRJJJRJRJJRMMMMMMMMMMMMMMMMMMMMMMMMMMMMMMMMMMMMMMMMMMMMMMMMMMMMMMMMMMMMMMMMMMMMMMMMMMMMMMMMMMMMMMMMMMMMMMMMMMMMMMMMMMMMMMMMMMMMMMMMMMMMMMMJJRJRJRJRRJJJJRJR
RRRJJJJJRRRJJJRRJJJJRRRRRJJJJRRJJRJRJRJRJRJRJRJRJJRJJJJJJRRRRRRRRRRRRJJJJRJRJRJJJRRJJJJRRRJJJRJRJRJRRJJRJRJRRJJJJJRJRJRJRJRJRJJJJJJJJJJJJJRRRRRJJJRJJRJJJJJRRJR
RRRRRRRJJJRRRRJJRRRRRRRRRRJJJJJJJJJJJJRRRRJJJJJRRRJRJRJRJRRJJRJRJRJRRRRRRRJJJJJJJJJRRRRRRRJJRJRJRJRJRJJJJRRRJJRJJJRJRJJJJJJJRRJRJRJRJRJRJRJRRJRJRJRJRJRRJRRRRRR