EEEEEEEEEEEEEEEEEEEEEEEEEEEEEEEEEEEEEEEEEEEEEEEEEEEEEEEEEEEEEEEEEEEEEEEEEEEEEEEEEEEEEEEEEEEEEEEEEEEEEEEEEEEEEEEEEEEEEEEEEEEEEEEEEEEEEEEEEEEEEEEEEEEEEEEEEEEEEEE
EEEEEEEEEEEEEEEEEEEEEEEE.EEE..EEEE.......EE.EEE..EEEEEEE.EEE.E.EEEEEEEEEEEEEEEEEEEE.EEEE.EEEEEEEEEE.EEEEEEE..E...EEEE...EEEEEEEE...EEEE...EEE....EEEEEEEEEEEEEE
EEEEEEEEEEEEEEEE..EE.....EEEEEEE........EEEE....EEE.E....EE..E..EEEEE.....E.....EE..E.E....E.E..EE.EEE.E.E...EE.....EEEE...E.EE...E.E.E.EEE..EEE..EEEEEEEEEEEEE
EEEEEEEEEEEEEE...........................d..............................d...........d.............d.......d.................d.....................EEEEEEEEEEEEE
EEEEEEEEEEEEE.........................................D.........................................................D....................d.....d......EEEEEEEEEEEEE
EEEEEEEEEEEEE............d......D..................................D............d..........d........d.............................................EEEEEEEEEEEEE
EEEEEEEEEEEEE...D..............................d...............d...........d.............................d......D........d......d...............D.EEEEEEEEEEEEE
EEEEEEEEEEEEE........P...F..........D....d...d..F.....D...........F.....d.....A.........d......d...A..................F...............d..d........EEEEEEEEEEEEE
EEEEEEEEEEEEEI..............d...d..........d......I.......d....d....d.....d......D.I.......d............d...d..I...d........d......d.d..........I.EEEEEEEEEEEEE
EEEEEEEEEEEEEMMMMMMMMMMMMMMMMMMMMMMMMMMMMMMMMMMMMMMMMMMMMMMMMMMMMMMMMMMMMMMMMMMMMMMMMMMMMMMMMMMMMMMMMMMMMMMMMMMMMMMMMMMMMMMMMMMMMMMMMMMMMMMMMMMMMMEEEEEEEEEEEEE
EEEEEEEEEEEEEEEEEEEEEEEEEEEEEEEEEEEEEEEEEEEEEEEEEEEEEEEEEEEEEEEEEEEEEEEEEEEEEEEEEEEEEEEEEEEEEEEEEEEEEEEEEEEEEEEEEEEEEEEEEEEEEEEEEEEEEEEEEEEEEEEEEEEEEEEEEEEEEEE
EEEEEEEEEEEEEEEEEEEEEEEEEEEEEEEEEEEEEEEEEEEEEEEEEEEEEEEEEEEEEEEEEEEEEEEEEEEEEEEEEEEEEEEEEEEEEEEEEEEEEEEEEEEEEEEEEEEEEEEEEEEEEEEEEEEEEEEEEEEEEEEEEEEEEEEEEEEEEEE