EEEEEEEEEEEEEEEEEEEEEEEEEEEEEEEEEEEEEEEEEEEEEEEEEEEEEEEEEEEEEEEEEEEEEEEEEEEEEEEEEEEEEEEEEEEEEEEEEEEEEEEEEEEEEEEEEEEEEEEEEEEEEEEEEEEEEEEEEEEEEEEEEEEEEEEEEEEEEEE
EEEEEEEEEEEEEEEEEEEEEEEE.EEE..EEEE.......EE.EEE..EEEEEEE.EEE.E.EEEEEEEEEEEEEEEEEEEE.EEEE.EEEEEEEEEE.EEEEEEE..E...EEEE...EEEEEEEE...EEEE...EEE....EEEEEEEEEEEEEE
EEEEEEEEEEEEEEEE..EE.....EEEEEEE........EEEE....EEE.E....EE..E..EEEEE.....E.....EE..E.E....E.E..EE.EEE.E.E...EE.....EEEE...E.EE...E.E.E.EEE..EEE..EEEEEEEEEEEEE
EEEEEEEEEEEEEE....................................................................................................................................EEEEEEEEEEEEE
EEEEEEEEEEEEE.....................................................................................................................................EEEEEEEEEEEEE
EEEEEEEEEEEEE.....................................................................................................................................EEEEEEEEEEEEE
EEEEEEEEEEEEE.....................................................................................................................................EEEEEEEEEEEEE
EEEEEEEEEEEEE........P............................................................................................................................EEEEEEEEEEEEE
EEEEEEEEEEEEE............C........................................................................................................................EEEEEEEEEEEEE
EEEEEEEEEEEEEMMMMMMMMMMMMMMMMMMMMMMMMMMMMMMMMMMMMMMMMMMMMMMMMMMMMMMMMMMMMMMMMMMMMMMMMMMMMMMMMMMMMMMMMMMMMMMMMMMMMMMMMMMMMMMMMMMMMMMMMMMMMMMMMMMMMMEEEEEEEEEEEEE
EEEEEEEEEEEEEEEEEEEEEEEEEEEEEEEEEEEEEEEEEEEEEEEEEEEEEEEEEEEEEEEEEEEEEEEEEEEEEEEEEEEEEEEEEEEEEEEEEEEEEEEEEEEEEEEEEEEEEEEEEEEEEEEEEEEEEEEEEEEEEEEEEEEEEEEEEEEEEEE
EEEEEEEEEEEEEEEEEEEEEEEEEEEEEEEEEEEEEEEEEEEEEEEEEEEEEEEEEEEEEEEEEEEEEEEEEEEEEEEEEEEEEEEEEEEEEEEEEEEEEEEEEEEEEEEEEEEEEEEEEEEEEEEEEEEEEEEEEEEEEEEEEEEEEEEEEEEEEEE